<?xml version="1.0" encoding="ISO-8859-1"?>
<SokobanLevels xmlns:xsi="http://www.w3.org/2001/XMLSchema-instance" xsi:schemaLocation="SokobanLev.xsd">
  <Title>Novoban</Title>
  <Description>
This collection of 50 levels is intended for beginners. The difficulty
of the levels is increasing. The collection ends with some medium
levels. I submitted these problems to my 10 and 14 year old nephews
who completed all in one day (which is not bad at all for complete
beginners). However, if you are an expert, solving the whole
collection in less than 45 minutes is quite a challenge.
  </Description>
  <Email>sokoban@online.fr</Email>
  <Url>http://sokoban.online.fr</Url>
  <LevelCollection Copyright="François Marques" MaxWidth="11" MaxHeight="11">
    <Level Id="Be ban 10" Width="6" Height="6">
      <L>####</L>
      <L>#  ###</L>
      <L>#  $@#</L>
      <L># *. #</L>
      <L>##   #</L>
      <L> #####</L>
    </Level>
  </LevelCollection>
</SokobanLevels>
